[console_scripts]
smry2arrow_batch = webviz_subsurface.smry2arrow_batch:main

[webviz_config_plugins]
AssistedHistoryMatchingAnalysis = webviz_subsurface.plugins:AssistedHistoryMatchingAnalysis
BhpQc = webviz_subsurface.plugins:BhpQc
CO2Leakage = webviz_subsurface.plugins:CO2Leakage
DiskUsage = webviz_subsurface.plugins:DiskUsage
EXPERIMENTALGridViewerFMU = webviz_subsurface.plugins:EXPERIMENTALGridViewerFMU
GroupTree = webviz_subsurface.plugins:GroupTree
HistoryMatch = webviz_subsurface.plugins:HistoryMatch
HorizonUncertaintyViewer = webviz_subsurface.plugins:HorizonUncertaintyViewer
InplaceVolumes = webviz_subsurface.plugins:InplaceVolumes
InplaceVolumesOneByOne = webviz_subsurface.plugins:InplaceVolumesOneByOne
LinePlotterFMU = webviz_subsurface.plugins:LinePlotterFMU
MapViewerFMU = webviz_subsurface.plugins:MapViewerFMU
MorrisPlot = webviz_subsurface.plugins:MorrisPlot
ParameterAnalysis = webviz_subsurface.plugins:ParameterAnalysis
ParameterCorrelation = webviz_subsurface.plugins:ParameterCorrelation
ParameterDistribution = webviz_subsurface.plugins:ParameterDistribution
ParameterParallelCoordinates = webviz_subsurface.plugins:ParameterParallelCoordinates
ParameterResponseCorrelation = webviz_subsurface.plugins:ParameterResponseCorrelation
ProdMisfit = webviz_subsurface.plugins:ProdMisfit
PropertyStatistics = webviz_subsurface.plugins:PropertyStatistics
PvtPlot = webviz_subsurface.plugins:PvtPlot
RelativePermeability = webviz_subsurface.plugins:RelativePermeability
ReservoirSimulationTimeSeries = webviz_subsurface.plugins:ReservoirSimulationTimeSeries
ReservoirSimulationTimeSeriesOneByOne = webviz_subsurface.plugins:ReservoirSimulationTimeSeriesOneByOne
ReservoirSimulationTimeSeriesRegional = webviz_subsurface.plugins:ReservoirSimulationTimeSeriesRegional
RftPlotter = webviz_subsurface.plugins:RftPlotter
RunningTimeAnalysisFMU = webviz_subsurface.plugins:RunningTimeAnalysisFMU
SegyViewer = webviz_subsurface.plugins:SegyViewer
SeismicMisfit = webviz_subsurface.plugins:SeismicMisfit
SimulationTimeSeries = webviz_subsurface.plugins:SimulationTimeSeries
StructuralUncertainty = webviz_subsurface.plugins:StructuralUncertainty
SubsurfaceMap = webviz_subsurface.plugins:SubsurfaceMap
SurfaceViewerFMU = webviz_subsurface.plugins:SurfaceViewerFMU
SurfaceWithGridCrossSection = webviz_subsurface.plugins:SurfaceWithGridCrossSection
SurfaceWithSeismicCrossSection = webviz_subsurface.plugins:SurfaceWithSeismicCrossSection
SwatinitQC = webviz_subsurface.plugins:SwatinitQC
TornadoPlotterFMU = webviz_subsurface.plugins:TornadoPlotterFMU
VolumetricAnalysis = webviz_subsurface.plugins:VolumetricAnalysis
WellAnalysis = webviz_subsurface.plugins:WellAnalysis
WellCompletion = webviz_subsurface.plugins:WellCompletion
WellCompletions = webviz_subsurface.plugins:WellCompletions
WellCrossSection = webviz_subsurface.plugins:WellCrossSection
WellCrossSectionFMU = webviz_subsurface.plugins:WellCrossSectionFMU
WellLogViewer = webviz_subsurface.plugins:WellLogViewer
